BBBBBBBBBBBBBBBBBBBBBBB
BaB     B BB    B     B
B   B B B    B  B B   B
B BBB BBB BBBB  B B   B
B   B     BB      B   B
B B B BBB BB B  BBB B B
B B B B   B  B   BB B B
B  B  B B B BB B B  B B
B B B   B B B  B B BB B
B     B B   B BB B BBpB
BBBBBBBBBBBBBBBBBBBBBBB